............................
............................
............................
CHHHHHHHHHHHHCCHHHHHHHHHHHHC
VFFFFFFFFFFFFVVFFFFFFFFFFFFV
VFCHHCFCHHHCFVVFCHHHCFCHHCFV
VOVNNVFVNNNVFVVFVNNNVFVNNVOV
VFCHHCFCHHHCFCCFCHHHCFCHHCFV
VFFFFFFFFFFFFFFFFFFFFFFFFFFV
VFCHHCFCCFCHHHHHHCFCCFCHHCFV
VFCHHCFVVFCHHCCHHCFVVFCHHCFV
VFFFFFFVVFFFFVVFFFFVVFFFFFFV
CHHHHCFVCHHC VV CHHCVFCHHHHC
NNNNNVFVCHHC CC CHHCVFVNNNNN
NNNNNVFVV          VVFVNNNNN
NNNNNVFVV CHHGGHHC VVFVNNNNN
HHHHHCFCC V      V CCFCHHHHH
      F   V      V   F      
HHHHHCFCC V      V CCFCHHHHH
NNNNNVFVV CHHHHHHC VVFVNNNNN
NNNNNVFVV          VVFVNNNNN
NNNNNVFVV CHHHHHHC VVFVNNNNN
CHHHHCFCC CHHCCHHC CCFCHHHHC
VFFFFFFFFFFFFVVFFFFFFFFFFFFV
VFCHHCFCHHHCFVVFCHHHCFCHHCFV
VFCHCVFCHHHCFCCFCHHHCFVCHCFV
VOFFVVFFFFFFF  FFFFFFFVVFFOV
CHCFVVFCCFCHHHHHHCFCCFVVFCHC
CHCFCCFVVFCHHCCHHCFVVFCCFCHC
VFFFFFFVVFFFFVVFFFFVVFFFFFFV
VFCHHHHCCHHCFVVFCHHCCHHHHCFV
VFCHHHHHHHHCFCCFCHHHHHHHHCFV
VFFFFFFFFFFFFFFFFFFFFFFFFFFV
CHHHHHHHHHHHHHHHHHHHHHHHHHHC
............................
............................