............................
............................
............................
CHHHHHHHHHHHHHHHHHHHHHHHHHHC
VFFFFFFFFFFFFFFFFFFFFFFFFFFV
VOCHHCFCCFCHHHHHHCFCCFCHHCOV
VFVCHCFVVFCHHCCHHCFVVFCHCVFV
VFVVFFFVVFFFFVVFFFFVVFFFVVFV
VFVVFCHCVFCCFVVFCCFVCHCFVVFV
VFCCFCHCVFVVFVVFVVFVCHCFCCFV
VFFFFFFVVFVVFCCFVVFVVFFFFFFV
VFCHHCFVVFVVFFFFVVFVVFCHHCFV
VFCHCVFVVFVCHHHHCVFVVFVCHCFV
VFFFVVFCCFCHHHHHHCFCCFVVFFFV
CHCFVVF              FVVFCHC
NNVFVVFCC CHHGGHHC CCFVVFVNN
NNVFCCFVV V      V VVFCCFVNN
NNVFFFFVV V      V VVFFFFVNN
NNVFCHHCV V      V VCHHCFVNN
CHCFCHHHC CHHHHHHC CHHHCFCHC
VFFFFFF              FFFFFFV
VFCHHHCFCHHCFCCFCHHCFCHHHCFV
VFCHHCVFVCHCFVVFCHCVFVCHHCFV
VFFFFVVFVVFFFVVFFFVVFVVFFFFV
CHHCFVVFVVFCHCCHCFVVFVVFCHHC
HHHCFCCFVVFCHHHHCFVVFCCFCHHH
    F  FVVF      FVVF  F    
HHHCFCCFVVFCHHHHCFVVFCCFCHHH
CHHCFVVFCCFCHCCHCFCCFVVFCHHC
VFFFFVVFFFFFFVVFFFFFFVVFFFFV
VOCHHCVFCHHCFVVFCHHCFVCHHCOV
VFCHHHCFCHHCFVVFCHHCFCHHHCFV
VFFFFFFFFFFFFVVFFFFFFFFFFFFV
CHHHHHHHHHHHHCCHHHHHHHHHHHHC
............................
............................